3648;3653;3642;3628;3611;3591;3555;3564;3602;3603;3553;3561;
1214;1234;1254;1353;1425;1443;1496;1531;1579;1654;1718;1754;
3649;3661;3674;3667;3679;3690;3681;3675;3670;3691;3695;3715;3794;3859;3876;3910;3932;
1215;1232;1256;1315;1366;1397;1425;1472;1507;1547;1634;1665;1719;1764;1765;1782;1813;
3377;3382;3381;3375;3368;3370;3364;3362;3351;3330;3282;3256;3246;3220;3192;3178;3161;
1335;1346;1360;1363;1369;1380;1387;1399;1410;1410;1400;1399;1388;1385;1388;1398;1412;
3377;3382;3381;3374;3369;3370;3367;3363;3365;3387;3405;3420;3431;3465;3481;3521;3530;3549;3577;3620;3643;3647;3648;
1335;1345;1360;1364;1368;1377;1385;1396;1412;1414;1406;1386;1373;1373;1379;1355;1321;1289;1267;1261;1242;1228;1214;
3289;3287;3280;3273;3275;3296;3314;3333;3352;3358;3369;3376;3376;3370;3365;3358;3347;3338;
372;385;399;412;428;442;451;456;476;488;512;520;531;542;562;571;580;592;
3128;3146;3154;3179;3190;3207;3222;3239;3247;3255;3266;3278;3284;3287;3289;
496;492;472;464;459;454;444;435;428;418;409;400;390;384;372;
3544;3553;3554;3554;3555;3560;3553;3537;3523;3506;3479;3462;3445;3432;3417;3397;3356;3324;3285;3274;3280;3286;3289;
701;678;660;644;620;611;601;590;582;574;564;560;548;530;512;488;452;440;425;408;398;384;373;
3545;3554;3554;3556;3560;3553;3527;3485;3462;3425;3404;3386;3369;3361;3338;
700;673;641;616;610;601;584;566;560;522;517;528;546;569;592;
3709;3719;3713;3715;3743;3784;3812;3909;3987;
1163;1194;1216;1258;1322;1382;1453;1548;1576;
3709;3707;3693;3747;3793;3836;3899;3918;3932;
1162;1226;1325;1483;1555;1653;1688;1743;1813;
3061;3055;3040;3033;3013;3007;3011;3018;3026;3029;3033;3035;3043;3053;
1384;1402;1438;1446;1454;1469;1486;1493;1501;1513;1527;1544;1555;1572;
3204;3195;3193;3199;3199;3205;3187;3177;3162;
1273;1281;1307;1318;1335;1364;1383;1398;1412;
3380;3381;3381;3379;3374;3371;3371;3365;3361;3355;3344;3335;3319;3309;3299;3277;3270;3262;3250;3244;3229;3216;3218;3212;3204;
1343;1344;1355;1360;1364;1369;1377;1386;1394;1401;1403;1403;1396;1396;1395;1391;1376;1358;1350;1332;1319;1310;1297;1288;1273;
3549;3562;3594;3601;3616;3619;3631;3643;3643;3644;3656;3672;3682;3685;3703;3714;3715;3706;3704;3702;3707;3713;3703;3699;3683;3663;3662;
696;677;675;681;705;718;723;736;750;765;783;795;808;828;836;853;868;879;891;910;924;943;957;971;978;988;995;
3646;3657;3667;3662;
950;960;983;996;
3646;3654;3657;3666;3686;3693;3709;3709;3703;3703;3707;3715;3715;3708;3700;3687;3682;3683;3675;3643;3640;3626;3611;3611;3598;3586;3567;3554;3545;
950;949;963;973;974;962;950;931;913;893;877;869;858;842;834;830;821;809;799;760;731;720;704;690;676;680;689;686;700;
2820;2834;2847;2860;2881;2891;2901;2913;2924;2938;2960;2978;2969;
236;229;227;228;233;238;250;261;268;273;293;303;320;
2307;2309;2338;2360;2386;2410;2430;2454;2473;2503;2558;2640;2742;2816;2971;3036;3076;3129;3146;3180;3218;3202;3156;3146;3152;3146;3127;
225;213;199;192;204;195;176;155;156;137;109;63;24;23;27;52;103;137;174;230;286;345;390;449;472;492;497;
2307;2309;2325;2345;2358;2377;2391;2418;2443;2458;2479;2504;2560;2616;2698;2809;2915;2974;3047;3084;3131;3152;3186;3218;3190;3223;3259;3278;3288;3288;
225;212;206;197;192;199;203;188;162;154;153;135;105;75;37;21;26;30;61;110;139;190;238;294;358;393;406;396;385;372;
2146;2139;2144;2158;2177;2196;2204;2242;2260;2292;2307;2308;2307;
232;224;211;209;211;209;192;178;190;198;206;213;226;
3561;3552;3565;3600;3634;3677;3702;3705;3723;3734;3739;3796;3837;3870;3898;3917;3932;
1754;1720;1701;1689;1684;1685;1699;1710;1726;1748;1771;1787;1779;1780;1783;1790;1813;
3692;3690;3683;3670;3665;3661;3658;3647;3660;3672;3697;3721;3752;3768;3786;3814;3887;3905;3918;3933;
2027;2030;2026;2023;2018;2009;1998;1972;1954;1935;1915;1892;1868;1828;1807;1781;1778;1784;1797;1813;
3052;3066;3096;3112;3131;3149;3164;3199;3263;3310;3371;3429;3504;3552;3551;3552;3560;
1573;1567;1568;1571;1577;1577;1583;1602;1630;1618;1619;1630;1690;1696;1718;1732;1754;
3052;3060;3062;3060;3056;3073;3082;3085;3101;3083;3056;3054;3060;3083;3093;3095;3094;3087;3078;3067;3053;
2076;2068;2050;2025;2000;1989;1966;1937;1882;1784;1721;1676;1654;1622;1599;1589;1578;1571;1566;1566;1572;
3054;3061;3061;3055;3058;3074;3089;3111;3149;3185;3224;3256;3294;3327;3347;3365;3381;3400;3436;3449;3473;3525;3577;3611;3648;3654;3657;3661;3664;3672;3685;3690;3692;
2073;2062;2031;2004;1995;1990;1969;1949;1920;1919;1927;1946;1957;1953;1951;1955;1945;1942;1946;1972;1997;1989;1973;1970;1977;1992;1997;2008;2016;2023;2027;2029;2025;
3560;3553;3541;3505;3502;3484;3485;3491;3489;3484;3486;3481;3475;3458;3457;3462;3475;3479;3492;
1754;1734;1725;1728;1746;1760;1771;1785;1813;1835;1858;1873;1890;1918;1940;1967;1992;2010;2020;
3399;3415;3429;3439;3476;3483;3502;3505;3535;3552;3560;
1838;1829;1832;1814;1790;1768;1745;1728;1723;1731;1753;
3272;3253;3243;3224;3184;3140;3091;3072;3055;3060;3061;3057;3051;
1867;1867;1868;1873;1894;1933;1969;1991;2005;2026;2047;2072;2076;
3310;3294;3286;3277;3276;3267;3254;3246;3230;3194;3179;3161;
1469;1468;1464;1457;1431;1408;1398;1389;1385;1387;1396;1411;
3270;3282;3296;3310;
1483;1474;1473;1469;
3283;3267;3257;3264;3238;3239;3252;3271;
1742;1744;1759;1775;1812;1843;1866;1867;
3282;3264;3264;3277;3298;3320;3344;3366;3439;3467;3509;3541;3551;3560;
1742;1741;1727;1721;1725;1732;1736;1717;1712;1698;1704;1717;1733;1754;
3488;3495;3501;3504;3509;3530;3538;3545;3552;3555;3560;
1728;1733;1735;1729;1726;1724;1724;1726;1733;1739;1754;
3392;3385;3376;3344;3345;3348;3317;3296;3292;3286;3270;
1642;1622;1615;1587;1555;1510;1483;1478;1473;1473;1482;
3392;3395;3408;3421;3432;3447;3462;3492;3516;3537;3550;3561;
1642;1635;1633;1637;1640;1645;1656;1682;1703;1712;1725;1754;
2783;2792;2799;2806;2820;2838;2850;2859;2865;2890;2944;2981;3029;3042;3055;3073;3071;3063;3052;
1477;1486;1502;1519;1525;1540;1565;1581;1603;1610;1620;1639;1635;1621;1594;1582;1569;1568;1572;
2630;2637;2643;2657;2665;2680;2736;2750;2768;2795;2803;2797;2783;
1530;1528;1534;1543;1564;1582;1567;1535;1525;1524;1515;1499;1477;
2630;2638;2646;2655;2661;2666;2673;2698;2710;2732;2750;2774;2794;2804;2804;2798;2798;2806;2823;2838;2856;2881;2939;2957;3001;3028;3041;3059;3072;3069;3053;
1530;1529;1536;1541;1553;1568;1581;1580;1586;1608;1615;1632;1637;1630;1631;1636;1644;1658;1659;1644;1634;1621;1619;1627;1639;1634;1619;1591;1580;1567;1572;
2843;2834;2822;2803;2799;2796;2788;2783;
1514;1510;1513;1515;1506;1494;1482;1477;
2833;2819;2802;2794;2778;2764;2749;2744;2729;2707;2689;2664;2658;2650;2639;2631;
1510;1514;1518;1525;1525;1526;1543;1559;1569;1578;1580;1566;1548;1536;1530;1529;
3143;3130;3133;3144;3151;3147;3143;3128;
570;568;553;539;524;505;496;496;
1421;1421;1427;1438;1467;1501;1581;1628;1674;1734;1838;1958;2067;2157;2201;2235;2256;2302;2315;2341;2358;2378;2385;
1329;1334;1340;1346;1349;1340;1336;1356;1401;1379;1355;1393;1353;1342;1338;1341;1364;1381;1398;1412;1404;1402;1402;
2385;2378;2364;2347;2337;2323;2328;2330;2323;2322;2334;2348;2354;2364;2374;
1403;1400;1403;1410;1409;1400;1382;1369;1352;1333;1322;1317;1315;1304;1294;
2238;2248;2261;2276;2286;2312;2325;2334;2348;2358;2373;2385;
1452;1465;1466;1454;1440;1433;1416;1408;1408;1403;1399;1402;
2471;2462;2453;2448;2440;2434;2430;2418;2406;2400;2388;2381;2372;2364;2363;2368;2374;
1280;1274;1278;1286;1295;1302;1311;1311;1309;1315;1317;1325;1326;1316;1307;1300;1294;
2427;2424;2421;2421;2419;2409;2400;2390;2381;2371;2360;2356;
1189;1198;1205;1211;1219;1219;1218;1212;1206;1206;1207;1215;
2270;2269;2268;2270;2271;2268;2261;2260;2269;2283;2295;2302;2299;2300;2311;2324;2327;2329;2323;2329;2341;2356;2370;2385;
1126;1130;1136;1143;1150;1159;1170;1183;1197;1215;1233;1260;1274;1306;1331;1349;1366;1388;1401;1407;1409;1403;1402;1402;
2270;2268;2268;2270;2270;2265;2259;2261;2264;2276;2284;2307;2313;2331;2352;2356;
1125;1132;1138;1145;1154;1162;1174;1180;1192;1207;1211;1202;1204;1204;1210;1215;
2187;2184;2185;2204;2219;2246;2268;2316;2337;2350;2375;
1387;1383;1368;1359;1343;1332;1319;1316;1320;1313;1294;
1421;1432;1460;1467;1504;1570;1636;1669;1756;1806;1875;1906;1987;2058;2151;2151;2191;2235;2274;2314;2336;2352;
1328;1316;1317;1295;1269;1256;1231;1200;1169;1152;1116;1074;1044;997;939;899;850;810;797;779;785;793;
2386;2372;2357;2335;2322;2308;2281;2245;2213;2198;2139;2160;2151;2177;2172;2154;2154;2146;2170;2212;2246;2276;2321;2351;
1402;1404;1405;1411;1404;1387;1375;1358;1337;1301;1243;1181;1119;1080;1031;982;930;901;873;829;805;793;778;793;
2251;2243;2221;2212;2184;2188;2241;2277;2323;2352;
938;947;935;904;875;850;808;792;780;792;
2251;2234;2227;2245;2258;2266;
937;960;984;1005;1019;1024;
2250;2230;2218;2200;2188;2175;2178;2158;2152;2160;2139;2190;2217;2280;2329;2369;2385;
938;966;982;1015;1028;1050;1073;1104;1140;1191;1231;1288;1339;1374;1407;1401;1402;
2630;2637;2647;2659;2660;2630;2602;2558;2524;2456;2404;2338;2317;2317;2312;2332;2352;2368;2385;
1530;1528;1536;1551;1590;1594;1606;1606;1580;1538;1523;1503;1482;1453;1433;1406;1405;1399;1402;
2748;2752;2745;2736;2727;
1105;1097;1085;1074;1061;
2747;2750;2745;2731;2715;2695;2686;
1101;1094;1084;1072;1073;1071;1066;
2745;2744;2743;2737;2735;
1114;1124;1133;1137;1148;
1205;1211;1214;1227;1249;1265;1263;1265;1276;1295;1299;1300;1305;
1752;1762;1781;1804;1810;1825;1849;1882;1916;1933;1953;1964;1971;
1205;1210;1236;1265;1317;1350;1392;1404;1412;
1752;1766;1769;1753;1754;1749;1736;1733;1729;
1299;1300;1313;1339;1364;1389;1422;1446;1478;1513;1595;1644;1669;1669;
1963;1956;1942;1952;1960;1954;1957;1977;2024;2052;2024;2033;2037;2028;
1668;1662;1690;1728;1747;1823;1975;1911;1897;1956;2074;2169;2211;2230;2252;2252;2245;2260;2269;2268;2269;
2033;2046;2059;2046;2024;1913;1836;1732;1595;1443;1344;1334;1335;1325;1288;1249;1191;1175;1157;1142;1126;
1369;1372;1378;1382;1388;1392;1415;1428;1461;1469;1463;1463;1458;1443;1433;1424;1421;
1229;1226;1227;1232;1241;1255;1276;1274;1282;1291;1300;1310;1317;1316;1315;1322;1328;
1369;1374;1381;1386;1389;1396;1420;1468;1606;1644;1683;1796;1897;1978;2042;2143;2151;2214;2265;2322;2351;
1228;1226;1231;1240;1249;1253;1253;1240;1249;1209;1193;1151;1079;1041;1010;949;899;824;798;778;792;
1546;1551;1590;1632;1722;1808;1875;1924;2007;2060;2147;2157;2208;2248;2318;2350;
1132;1137;1123;1122;1129;1123;1051;1026;1016;999;943;891;833;805;779;792;
1546;1549;1558;1573;1611;1646;1689;1781;1853;1964;2076;2160;2219;2249;2279;2317;2324;2343;2363;2386;
1131;1141;1155;1159;1183;1220;1270;1291;1320;1350;1316;1303;1309;1344;1361;1388;1402;1406;1403;1402;
1996;2008;2016;2024;2051;2085;2117;2150;2162;2188;2235;2276;2310;2332;2350;
922;915;912;906;900;884;884;887;877;851;808;793;778;782;792;
1996;2003;2022;2051;2063;2075;2109;2108;2114;2148;2179;2169;2159;2155;2157;2182;2218;2249;2263;2268;2269;
923;917;908;903;923;949;984;1010;1029;1050;1072;1090;1104;1128;1170;1188;1187;1183;1169;1148;1126;
1639;1642;1649;1656;1669;1684;1751;1800;1876;1937;1987;2000;1995;
841;846;850;849;855;865;903;896;913;896;906;920;923;
1639;1643;1655;1668;1694;1714;1761;1783;1855;1978;2028;2138;2218;2264;2307;2349;
842;849;852;854;870;880;879;871;845;807;832;809;801;793;779;791;
1641;1638;1637;1637;1648;1667;1683;1716;1748;1771;1785;1786;1789;1788;1765;1757;1748;1739;1715;1671;1653;1634;1617;1587;1556;1546;1545;
666;670;676;688;710;721;768;774;777;793;809;837;856;905;926;949;998;1008;1023;1045;1075;1104;1120;1122;1136;1134;1131;
1641;1635;1628;1649;1672;1687;1711;1709;1715;
666;674;697;712;716;737;760;797;804;
1745;1734;1722;1711;1710;1710;1715;
738;740;756;769;784;800;804;
1642;1643;1654;1661;1673;1681;1691;
846;850;852;851;849;848;845;
1995;2001;1991;1986;1992;2008;2027;2043;2052;2052;2038;
923;916;908;891;871;859;803;806;782;764;751;
2180;2179;2179;2176;2176;2178;2188;2206;2219;2255;2273;2288;2311;2324;2330;2338;2348;2351;
623;630;635;640;645;657;669;677;683;707;733;746;768;771;779;787;790;792;
2324;2325;2323;2322;2325;2323;2318;2329;2332;2330;2328;2331;2337;2345;2351;
642;646;654;660;668;686;697;712;729;742;760;772;780;786;792;
2351;2344;2320;2301;2233;2194;2171;2155;2152;2152;2163;2166;2180;2178;2158;2152;2171;2222;2239;2234;2257;2294;2286;2289;2298;2312;2315;2336;2394;2468;2492;2561;2625;2650;2659;2656;2642;2630;
793;786;781;784;812;845;869;890;924;944;989;1036;1064;1091;1112;1143;1183;1196;1232;1252;1277;1339;1357;1383;1410;1449;1475;1502;1517;1543;1566;1606;1601;1589;1565;1545;1533;1530;
1860;1872;1892;1898;1906;1940;1965;1985;1992;1999;2015;2035;2038;2038;
515;511;514;522;549;589;627;679;730;756;773;767;755;751;
1860;1873;1897;1911;1911;1950;1972;2006;2057;2074;2082;2125;2142;2166;2177;2176;2177;2179;2180;
516;504;507;532;564;599;651;677;701;731;765;759;715;698;670;651;638;633;622;
1860;1870;1894;1902;1893;1894;1890;1922;1938;1969;2054;2112;2168;2228;2278;2317;2344;2352;
516;508;514;540;550;593;656;724;786;812;827;811;810;797;782;778;785;793;
1860;1863;1875;1888;1893;1890;1868;1846;1860;1871;1851;1818;1786;1730;1658;1599;1546;
515;514;508;516;532;549;593;650;710;835;870;926;978;1026;1093;1125;1131;
1633;1638;1646;1646;1640;1636;1641;
745;734;720;710;695;684;666;
1636;1640;1654;1688;1753;1784;1811;1842;1852;1875;1901;1897;1884;1860;
738;731;727;726;717;695;667;656;625;572;540;518;509;516;
1860;1874;1892;1920;1929;1934;1964;1968;1982;2001;2021;2051;2097;2127;2138;2145;
515;498;497;472;451;416;391;367;330;302;265;244;229;216;222;231;
2180;2179;2177;2176;2176;2173;2156;2144;2129;2106;2079;2070;2055;2015;1975;1956;1921;1907;1923;1932;1930;1959;1970;1993;2012;2051;2095;2126;2144;
623;628;639;644;659;686;703;717;751;765;758;727;699;678;652;611;569;534;468;442;416;393;358;313;272;244;229;217;231;
1666;1690;1702;1729;1752;1797;1824;1851;1880;1892;1899;1910;1923;1928;1918;1904;1880;1864;1861;
133;140;155;177;177;212;245;289;336;359;393;409;436;451;475;486;497;509;515;
1666;1693;1732;1796;1840;1939;2005;2064;2106;2130;2138;2145;
132;128;124;125;147;163;149;172;186;211;221;231;
1023;1039;1071;1078;1087;1143;1186;1224;1271;1314;1335;1397;1459;1537;1552;1605;1647;1671;1673;1670;1666;
236;224;225;209;196;165;133;104;97;94;81;71;85;96;86;88;99;113;124;130;132;
631;625;614;605;604;600;594;590;608;636;645;676;696;725;749;781;802;834;869;918;932;951;969;1005;1017;1040;1060;1060;1052;1036;1023;
289;293;291;280;262;253;240;212;200;196;180;171;173;160;152;132;114;99;94;92;103;116;122;156;168;168;178;197;212;225;234;
1420;1422;1435;1445;1472;1501;1525;1592;1673;1754;1866;1892;1991;2034;2201;2228;2331;2398;2426;2463;
1329;1337;1346;1348;1360;1386;1412;1482;1526;1580;1639;1706;1808;1840;1953;2067;2113;2134;2165;2142;
1097;1090;1050;1031;974;962;955;908;841;809;782;738;726;698;694;670;646;635;
1563;1563;1554;1554;1576;1592;1647;1662;1626;1640;1639;1635;1617;1598;1577;1569;1567;1559;
1098;1090;1070;1059;1052;1040;1038;1042;1079;1099;1111;1166;1198;1209;1205;
1563;1566;1574;1587;1612;1633;1654;1676;1704;1737;1755;1768;1775;1768;1752;
1303;1298;1290;1291;1301;1320;1345;1378;1407;1511;1608;1688;1764;1928;2060;2200;2364;2427;2462;
2003;2005;2009;2014;2025;2029;2037;2051;2111;2142;2167;2173;2141;2186;2244;2277;2238;2167;2142;
1303;1296;1290;1292;1297;1312;1321;1335;1408;1574;1574;1700;1820;1904;1946;1998;2051;2068;2067;2077;2089;2090;
2003;2007;2011;2019;2040;2075;2119;2208;2242;2328;2439;2570;2601;2637;2690;2741;2811;2841;2877;2886;2885;2887;
2705;2702;2697;2694;2693;2694;2682;2648;2612;2592;2544;2508;2462;2462;2437;2419;2386;2247;2217;2187;2189;2205;2257;2301;2312;2312;2329;2359;2383;2386;
2392;2396;2404;2410;2421;2455;2470;2473;2461;2452;2451;2400;2333;2284;2201;2155;2125;2075;1994;1933;1803;1673;1575;1489;1452;1430;1406;1404;1402;1402;
2705;2689;2687;2694;2695;2675;2644;2612;2581;2538;2493;2356;2227;2130;1988;1881;1684;1531;1518;1511;1544;1519;1465;1430;1421;1420;
2392;2399;2419;2436;2458;2465;2477;2463;2449;2456;2403;2350;2239;2098;2002;1919;1800;1668;1574;1492;1421;1382;1348;1342;1334;1329;
2538;2539;2537;2534;2523;2513;2507;2521;2534;2525;2524;2537;2585;2626;2676;2694;2686;2705;
2199;2203;2216;2239;2258;2277;2335;2352;2370;2399;2424;2441;2454;2465;2475;2441;2417;2392;
2538;2539;2526;2498;2435;2428;2397;2260;2216;2214;2122;1973;1897;1861;1792;1674;1549;1512;1447;1425;1421;
2199;2209;2223;2240;2206;2174;2131;2090;2018;1967;1893;1787;1707;1642;1593;1534;1438;1391;1349;1339;1329;
2652;2652;2665;2678;2691;2695;2693;2696;2702;2706;
2509;2501;2490;2469;2460;2440;2423;2408;2393;2391;
2533;2533;2533;2497;2441;2359;2330;2218;2158;2025;1910;1687;1515;1387;1351;1304;1307;1315;
2338;2345;2358;2367;2363;2287;2222;2122;2032;1909;1852;1776;1799;1776;1762;1751;1711;1701;
2462;2452;2441;2452;2479;2479;2501;2542;2604;2650;2693;2786;2886;2962;3018;3043;3054;3061;3060;3058;3053;
2142;2145;2135;2104;2072;2027;1981;1964;1937;1924;1942;1955;1946;1944;1956;1984;2005;2037;2065;2070;2076;
2660;2669;2669;2677;2683;
2149;2156;2167;2196;2199;
2653;2656;2660;2670;2681;2687;
2079;2084;2091;2096;2097;2089;
2654;2661;2668;2682;2694;2710;2718;2722;2734;2741;2754;2760;2764;2768;2772;2776;2788;2798;2807;2811;
2080;2080;2075;2065;2062;2061;2071;2075;2081;2085;2096;2106;2113;2115;2119;2123;2123;2124;2125;2124;
2705;2702;2691;2679;2671;2667;2661;2653;
2050;2054;2060;2065;2070;2075;2079;2080;
2600;2590;2590;2591;
1992;2000;2004;2008;
2462;2440;2440;2458;2475;2476;2445;2418;2386;2369;
2141;2138;2111;2076;2051;2028;1968;1947;1923;1907;
2589;2581;2564;2534;2492;2483;2477;2458;2442;2438;2459;
1886;1893;1906;1916;1981;2015;2043;2080;2104;2134;2141;
2596;2597;2606;2607;2586;2598;2615;2668;2668;2655;2630;
1874;1865;1846;1808;1733;1673;1647;1611;1582;1544;1529;
2369;2369;2359;2365;2357;2326;2285;2297;2305;2310;2324;2384;
1883;1862;1839;1811;1774;1705;1612;1546;1500;1441;1409;1402;
1658;1656;1643;1640;1640;1653;1668;1668;
2201;2186;2161;2114;2076;2065;2033;2030;
1850;1852;1880;1903;1947;1986;
2236;2254;2305;2325;2339;2382;
2629;2647;2663;2655;2640;2552;2511;2360;2270;2246;2220;2223;2239;2237;2214;2233;2248;
1530;1537;1570;1596;1627;1728;1770;1805;1823;1946;2012;2065;2178;2354;2440;2496;2518;
2352;2356;2371;2402;2409;2417;2457;2478;2502;2523;2573;2607;2643;2687;2696;2696;2704;
2473;2465;2461;2459;2435;2415;2394;2393;2408;2441;2445;2457;2467;2465;2435;2405;2391;
2419;2415;2403;2393;2375;2373;2370;2360;2346;2350;2354;2354;
3152;3155;3157;3157;3149;3139;3132;3116;3070;3061;3048;3016;
2419;2412;2391;2374;2360;2339;2327;2305;2285;2262;2257;2256;
3152;3156;3157;3156;3162;3165;3171;3182;3188;3202;3212;3225;
2163;2170;2183;2192;
3385;3375;3373;3361;
2074;2073;2073;2081;2106;2119;2123;
3344;3323;3298;3282;3261;3243;3233;
2100;2104;2111;2118;2122;
3250;3248;3243;3237;3233;
1965;1962;1966;1976;1980;2004;2030;2052;2067;2073;2073;2073;
3160;3163;3170;3175;3190;3224;3241;3263;3281;3294;3319;3343;
1965;1961;1968;1977;1981;1998;2040;2045;2052;2097;2151;2189;2190;2224;2258;2282;2332;2373;2410;2418;
3160;3162;3170;3175;3193;3211;3233;3256;3277;3287;3272;3265;3238;3203;3194;3188;3167;3155;3156;3152;
1958;1960;1969;1981;2026;2058;2110;2120;
3502;3494;3480;3478;3474;3465;3446;3440;
1958;1958;1965;1936;1913;1888;1864;1849;1840;1812;1783;1776;1777;
3502;3490;3473;3463;3473;3487;3491;3503;3518;3515;3494;3485;3482;
1958;1961;1975;2020;2057;2079;2121;2173;2214;2234;2249;2251;
3502;3486;3474;3472;3464;3474;3487;3468;3461;3456;3448;3447;
2275;2265;2260;2244;2225;2201;2197;2205;2220;2244;2250;
3568;3565;3549;3532;3526;3512;3486;3471;3460;3451;3447;
1910;1923;1940;1985;2010;2055;2105;2126;2168;2192;
3321;3320;3327;3325;3308;3309;3319;3342;3358;3360;
1957;1964;1971;1974;1967;1947;1935;1928;1922;1910;
3501;3484;3467;3429;3379;3346;3328;3323;3319;3321;
1957;1960;1975;2008;2024;2030;2052;2063;
3502;3485;3469;3454;3433;3417;3379;3374;
1966;1959;1953;1963;1986;2003;2031;2112;2168;2197;2266;2332;2364;2405;2442;2449;2466;
3881;3886;3897;3911;3919;3917;3908;3893;3917;3944;3959;3948;3898;3868;3834;3799;3774;
2467;2464;2471;2508;2564;2675;2766;2789;
3774;3781;3797;3806;3798;3741;3764;3769;
2825;2829;2839;2853;2867;2885;2893;
3758;3753;3751;3752;3753;3750;3739;
1746;1742;1735;1733;1736;1751;1717;1740;1766;1838;1825;1828;1840;1847;
3392;3393;3397;3415;3450;3482;3499;3548;3581;3634;3641;3651;3665;3668;
1830;1828;1817;1807;1800;1813;1838;1936;1936;1969;2030;2066;2069;2069;2069;2077;2088;
3057;3051;3042;3038;3015;2967;2947;2915;2863;2819;2815;2837;2859;2870;2880;2885;2885;
1829;1797;1777;1755;1735;1708;1704;1711;1713;1690;1645;1648;1651;1653;1661;1689;1715;1732;1746;
3056;3025;3031;3050;3074;3083;3104;3128;3158;3156;3165;3204;3234;3292;3333;3371;3392;3394;3392;
1847;1825;1789;1740;1714;1701;1686;1664;1638;1639;1640;1652;1669;
2235;2241;2222;2193;2167;2169;2177;2175;2155;2107;2081;2066;2029;
1985;1995;2023;2083;2157;2243;2302;2401;2426;2460;
2381;2365;2354;2354;2335;2267;2261;2204;2165;2140;
2247;2235;2216;2200;2186;
2519;2503;2496;2493;2482;
2089;2075;2068;2068;2075;2081;2090;2096;2093;2106;2160;2186;2235;2248;
2886;2883;2874;2859;2819;2802;2778;2731;2679;2619;2583;2544;2519;2519;
497;494;484;478;463;456;442;426;403;375;331;309;291;283;297;299;301;
424;427;430;436;436;431;414;394;382;393;442;460;493;514;523;534;542;
420;425;441;446;472;504;554;578;595;628;632;647;654;660;667;
995;997;1005;992;973;972;962;946;921;891;872;873;884;896;900;
667;661;654;646;652;663;673;676;
900;899;882;868;861;858;853;847;
667;660;651;641;620;586;579;583;601;607;641;678;713;749;815;838;
900;892;879;872;897;933;959;1005;1037;1073;1122;1140;1139;1173;1190;1205;
839;817;801;784;761;750;747;729;713;705;683;646;616;605;594;591;570;573;573;576;590;605;627;634;
1204;1190;1191;1199;1210;1229;1243;1254;1273;1289;1309;1333;1357;1369;1403;1419;1439;1459;1482;1513;1538;1555;1567;1559;
3985;3974;3954;3943;3939;3915;3904;3904;3917;3924;3929;3932;
1575;1573;1582;1605;1636;1658;1684;1693;1731;1767;1796;1811;
4318;4326;4347;4370;4370;4361;4314;4235;4180;4128;4048;4025;
1966;1962;1962;1937;1906;1884;1825;1765;1754;1659;1554;1571;
4319;4335;4363;4398;4439;4431;4409;4368;
1964;1964;1977;2005;2031;2107;2150;2181;
4368;4374;4393;4415;4454;4504;4550;4581;4584;4586;4589;
2180;2173;2166;2168;2180;2163;2150;2179;2259;2290;2306;
4608;4614;4613;4599;4544;4477;4465;4466;
2923;2912;2868;2839;2784;2741;2723;2702;
4608;4620;4639;4679;4720;4740;4732;4731;
2924;2904;2894;2865;2801;2680;2640;2634;
4608;4624;4659;4693;4722;4735;4780;4818;4827;4839;4805;
2924;2903;2892;2870;2795;2717;2672;2618;2547;2460;2432;
4589;4581;4590;4633;4644;4696;4723;4748;4806;4845;4825;4806;
2305;2284;2267;2264;2271;2280;2303;2318;2351;2393;2428;2433;
4609;4615;4637;4661;4679;4667;4652;4627;4575;4571;
2923;2908;2898;2910;2938;2976;3005;3023;3034;3043;
4886;4865;4839;4795;4749;4720;
3221;3221;3221;3248;3248;3222;
4764;4780;4806;4836;4847;4883;
3314;3291;3276;3249;3230;3220;
4616;4622;4624;4634;4640;
3395;3391;3381;3374;3369;
4498;4500;4515;4524;4512;
3358;3338;3324;3306;3295;
4498;4480;4449;4437;4385;
3358;3348;3360;3370;3369;
4355;4355;4348;4350;4351;
3296;3316;3332;3352;3355;
4365;4371;4380;
3268;3256;3250;
4267;4274;4290;4304;4342;4348;
3217;3209;3211;3198;3187;3191;
4267;4277;4294;4306;4317;4319;
3216;3204;3198;3182;3159;3151;
4330;4328;4325;4324;
3071;3061;3054;3051;
4213;4213;4219;
3154;3147;3143;
4101;4097;4094;4084;4084;4103;4134;4139;
3094;3097;3105;3111;3136;3157;3163;3165;
4165;4146;4124;4082;4059;4045;4029;4022;
3255;3255;3256;3249;3225;3221;3234;3241;
4022;4052;4058;4055;4081;4096;4101;
3240;3207;3176;3157;3110;3104;3093;
4022;4041;4085;4102;4144;4174;4276;4298;4326;4356;4375;4379;
3240;3223;3233;3255;3275;3282;3305;3279;3246;3250;3253;3250;
4069;4066;4057;4041;4009;4003;3958;3976;4022;4047;4047;4037;4023;
2912;2922;2938;2949;2964;2977;3021;3060;3143;3160;3194;3227;3240;
4003;4000;4001;4005;3991;3975;3972;3986;4009;4034;4052;4047;4041;4022;
2909;2923;2950;2966;2987;3019;3048;3070;3109;3138;3165;3188;3217;3239;
3798;3792;3810;3927;3972;4032;4055;4030;
3024;3051;3077;3071;3097;3148;3183;3244;
4041;4057;4052;4029;3988;3951;3889;3834;3775;3768;
3223;3202;3167;3132;3106;3088;3066;3077;3110;3120;
3621;3631;3647;3659;
3470;3461;3462;3450;
3588;3584;3582;
3522;3530;3539;
3593;3592;3609;3612;
3574;3586;3591;3589;
3611;3598;3577;3539;3460;3429;3421;
3590;3598;3604;3613;3617;3632;3632;
4571;4579;4597;4658;4676;4692;4731;4755;4798;4830;4847;4867;4884;
3042;3034;3031;3025;3038;3046;3065;3087;3127;3156;3198;3220;3220;
1630;1634;1636;1634;1627;1567;1489;1445;1423;1420;
1597;1580;1563;1537;1513;1453;1377;1342;1338;1329;
1420;1420;1430;1473;1507;1572;1716;1874;2036;2096;2209;2280;2323;2335;2364;2385;
1330;1333;1339;1345;1381;1429;1435;1444;1401;1360;1341;1362;1397;1405;1402;1403;
2385;2372;2344;2329;2322;2318;2328;2348;2358;2374;
1403;1402;1405;1401;1375;1343;1322;1310;1293;1294;
2427;2422;2423;2418;2408;
1188;1198;1210;1227;1240;
2269;2267;2271;2266;2253;2254;2270;2286;2296;2315;2318;2329;2369;2385;
1127;1133;1144;1160;1172;1204;1245;1284;1332;1359;1392;1407;1402;1402;
2269;2265;2271;2263;2241;2194;2114;2018;1944;1831;1731;1652;1561;1492;1438;1421;1419;
1126;1137;1151;1173;1180;1223;1322;1381;1422;1428;1425;1433;1416;1370;1341;1336;1330;
3053;3068;3102;3128;3209;3259;3297;3349;3379;3360;3368;3371;3376;3381;3382;3377;
1572;1566;1572;1567;1545;1541;1565;1520;1441;1402;1382;1372;1361;1357;1345;1334;
3377;3380;3380;3379;3372;3369;3365;3360;3370;3401;3423;3480;3509;3543;3595;3629;3652;3664;3660;3651;3648;
1334;1342;1353;1360;1366;1380;1387;1405;1416;1414;1402;1386;1362;1308;1285;1263;1236;1217;1205;1205;1214;
1420;1423;1441;1474;1520;1664;1760;1923;2003;2115;2222;2308;2325;2349;2373;2386;
1329;1337;1342;1342;1342;1380;1398;1427;1367;1337;1333;1384;1405;1403;1402;1402;
1420;1422;1427;1457;1514;1552;1585;1733;1806;1901;1995;2096;2219;2288;2317;2353;2378;2385;
1328;1335;1339;1340;1326;1331;1356;1333;1333;1352;1349;1315;1339;1378;1410;1407;1404;1403;
3204;3211;3219;3229;3229;
1300;1313;1321;1331;1346;